TEST_MAP_1
25
25
0000001000000100000000000 
1111101111110111111111110 
0100101000000100000000000 
0000101010000101111111111 
0111100011110100000000000 
0000101000000111111110111 
1101101111000101000010000 
0001001000011100010011110 
0101001011000111110010000 
0101000010011100010010111 
0100001000000101010010000 
1111101111011101010011110 
0000101000000101010010000 
0110101010110101010010111 
0110100010010101010010000 
0010001000010101010011110 
1111101111011101010000000 
0100101000000001011111110 
0100101010011111010001000 
0100100010000000010101010 
0000001000000000010101010 
1111101111111111010101010 
0010001000000000010101010 
0110101010111111110101010 
0000100010000000000100010 


