TEST_MAP_1
100
100
0000001000000100000000000000000100000010000000000000000010000001000000000000000001000000100000000000 
1111101111110111111111110111110111111011111111111011111011111101111111111101111101111110111111111110 
0100101000000100000000000010010100000010000000000001001010000001000000000000100101000000100000000000 
0000101010000101111111111000010101000010111111111100001010100001011111111110000101010000101111111111 
0111100011110100000000000011110001111010000000000001111000111101000000000000111100011110100000000000 
0000101000000111111110111000010100000011111111011100001010000001111111101110000101000000111111110111 
1101101111000101000010000110110111100010100001000011011011110001010000100001101101111000101000010000 
0001001000011100010011110000100100001110001001111000010010000111000100111100001001000011100010011110 
0101001011000111110010000010100101100011111001000001010010110001111100100000101001011000111110010000 
0101000010011100010010111010100001001110001001011101010000100111000100101110101000010011100010010111 
0100001000000101010010000010000100000010101001000001000010000001010100100000100001000000101010010000 
1111101111011101010011110111110111101110101001111011111011110111010100111101111101111011101010011110 
0000101000000101010010000000010100000010101001000000001010000001010100100000000101000000101010010000 
0110101010110101010010111011010101011010101001011101101010101101010100101110110101010110101010010111 
0110100010010101010010000011010001001010101001000001101000100101010100100000110100010010101010010000 
0010001000010101010011110001000100001010101001111000100010000101010100111100010001000010101010011110 
1111101111011101010000000111110111101110101000000011111011110111010100000001111101111011101010000000 
0100101000000001011111110010010100000000101111111001001010000000010111111100100101000000001011111110 
0100101010011111010001000010010101001111101000100001001010100111110100010000100101010011111010001000 
0100100010000000010101010010010001000000001010101001001000100000000101010100100100010000000010101010 
0000001000000000010101010000000100000000001010101000000010000000000101010100000001000000000010101010 
1111101111111111010101010111110111111111101010101011111011111111110101010101111101111111111010101010 
0010001000000000010101010001000100000000001010101000100010000000000101010100010001000000000010101010 
0110101010111111110101010011010101011111111010101001101010101111111101010100110101010111111110101010 
0000100010000000000100010000010001000000000010001000001000100000000001000100000100010000000000100010 
0000001000000100000000000000000100000010000000000000000010000001000000000000000001000000100000000000
1111101111110111111111110111110111111011111111111011111011111101111111111101111101111110111111111110
0100101000000100000000000010010100000010000000000001001010000001000000000000100101000000100000000000
0000101010000101111111111000010101000010111111111100001010100001011111111110000101010000101111111111
0111100011110100000000000011110001111010000000000001111000111101000000000000111100011110100000000000
0000101000000111111110111000010100000011111111011100001010000001111111101110000101000000111111110111
1101101111000101000010000110110111100010100001000011011011110001010000100001101101111000101000010000
0001001000011100010011110000100100001110001001111000010010000111000100111100001001000011100010011110
0101001011000111110010000010100101100011111001000001010010110001111100100000101001011000111110010000
0101000010011100010010111010100001001110001001011101010000100111000100101110101000010011100010010111
0100001000000101010010000010000100000010101001000001000010000001010100100000100001000000101010010000
1111101111011101010011110111110111101110101001111011111011110111010100111101111101111011101010011110
0000101000000101010010000000010100000010101001000000001010000001010100100000000101000000101010010000
0110101010110101010010111011010101011010101001011101101010101101010100101110110101010110101010010111
0110100010010101010010000011010001001010101001000001101000100101010100100000110100010010101010010000
0010001000010101010011110001000100001010101001111000100010000101010100111100010001000010101010011110
1111101111011101010000000111110111101110101000000011111011110111010100000001111101111011101010000000
0100101000000001011111110010010100000000101111111001001010000000010111111100100101000000001011111110
0100101010011111010001000010010101001111101000100001001010100111110100010000100101010011111010001000
0100100010000000010101010010010001000000001010101001001000100000000101010100100100010000000010101010
0000001000000000010101010000000100000000001010101000000010000000000101010100000001000000000010101010
1111101111111111010101010111110111111111101010101011111011111111110101010101111101111111111010101010
0010001000000000010101010001000100000000001010101000100010000000000101010100010001000000000010101010
0110101010111111110101010011010101011111111010101001101010101111111101010100110101010111111110101010
0000100010000000000100010000010001000000000010001000001000100000000001000100000100010000000000100010
0000001000000100000000000000000100000010000000000000000010000001000000000000000001000000100000000000
1111101111110111111111110111110111111011111111111011111011111101111111111101111101111110111111111110
0100101000000100000000000010010100000010000000000001001010000001000000000000100101000000100000000000
0000101010000101111111111000010101000010111111111100001010100001011111111110000101010000101111111111
0111100011110100000000000011110001111010000000000001111000111101000000000000111100011110100000000000
0000101000000111111110111000010100000011111111011100001010000001111111101110000101000000111111110111
1101101111000101000010000110110111100010100001000011011011110001010000100001101101111000101000010000
0001001000011100010011110000100100001110001001111000010010000111000100111100001001000011100010011110
0101001011000111110010000010100101100011111001000001010010110001111100100000101001011000111110010000
0101000010011100010010111010100001001110001001011101010000100111000100101110101000010011100010010111
0100001000000101010010000010000100000010101001000001000010000001010100100000100001000000101010010000
1111101111011101010011110111110111101110101001111011111011110111010100111101111101111011101010011110
0000101000000101010010000000010100000010101001000000001010000001010100100000000101000000101010010000
0110101010110101010010111011010101011010101001011101101010101101010100101110110101010110101010010111
0110100010010101010010000011010001001010101001000001101000100101010100100000110100010010101010010000
0010001000010101010011110001000100001010101001111000100010000101010100111100010001000010101010011110
1111101111011101010000000111110111101110101000000011111011110111010100000001111101111011101010000000
0100101000000001011111110010010100000000101111111001001010000000010111111100100101000000001011111110
0100101010011111010001000010010101001111101000100001001010100111110100010000100101010011111010001000
0100100010000000010101010010010001000000001010101001001000100000000101010100100100010000000010101010
0000001000000000010101010000000100000000001010101000000010000000000101010100000001000000000010101010
1111101111111111010101010111110111111111101010101011111011111111110101010101111101111111111010101010
0010001000000000010101010001000100000000001010101000100010000000000101010100010001000000000010101010
0110101010111111110101010011010101011111111010101001101010101111111101010100110101010111111110101010
0000100010000000000100010000010001000000000010001000001000100000000001000100000100010000000000100010
0000001000000100000000000000000100000010000000000000000010000001000000000000000001000000100000000000
1111101111110111111111110111110111111011111111111011111011111101111111111101111101111110111111111110
0100101000000100000000000010010100000010000000000001001010000001000000000000100101000000100000000000
0000101010000101111111111000010101000010111111111100001010100001011111111110000101010000101111111111
0111100011110100000000000011110001111010000000000001111000111101000000000000111100011110100000000000
0000101000000111111110111000010100000011111111011100001010000001111111101110000101000000111111110111
1101101111000101000010000110110111100010100001000011011011110001010000100001101101111000101000010000
0001001000011100010011110000100100001110001001111000010010000111000100111100001001000011100010011110
0101001011000111110010000010100101100011111001000001010010110001111100100000101001011000111110010000
0101000010011100010010111010100001001110001001011101010000100111000100101110101000010011100010010111
0100001000000101010010000010000100000010101001000001000010000001010100100000100001000000101010010000
1111101111011101010011110111110111101110101001111011111011110111010100111101111101111011101010011110
0000101000000101010010000000010100000010101001000000001010000001010100100000000101000000101010010000
0110101010110101010010111011010101011010101001011101101010101101010100101110110101010110101010010111
0110100010010101010010000011010001001010101001000001101000100101010100100000110100010010101010010000
0010001000010101010011110001000100001010101001111000100010000101010100111100010001000010101010011110
1111101111011101010000000111110111101110101000000011111011110111010100000001111101111011101010000000
0100101000000001011111110010010100000000101111111001001010000000010111111100100101000000001011111110
0100101010011111010001000010010101001111101000100001001010100111110100010000100101010011111010001000
0100100010000000010101010010010001000000001010101001001000100000000101010100100100010000000010101010
0000001000000000010101010000000100000000001010101000000010000000000101010100000001000000000010101010
1111101111111111010101010111110111111111101010101011111011111111110101010101111101111111111010101010
0010001000000000010101010001000100000000001010101000100010000000000101010100010001000000000010101010
0110101010111111110101010011010101011111111010101001101010101111111101010100110101010111111110101010
0000100010000000000100010000010001000000000010001000001000100000000001000100000100010000000000100010

